11111111
1P1CE111
10001001
10000001
11111111
