1111111111
1000000001
100C000001
10000001E1
10000001P1
1111111111
