1111111111
1000000001
100C0P0001
10001001E1
1111100001
10001001C1
1111111111
